{

  "layout": [

    [0,0,1,1,1,1,1,0,0],

    [0,2,2,8,8,8,8,2,2,0],

    [0,3,3,5,3,5,3,3,0],

    [0,1,2,3,6,3,2,1,0],

    [3,3,3,3,7,3,3,3,3],

    [4,8,8,8,8,8,8,8,4]

  ]

}
