{
    "levels": [
{
        "background": "bg2.png",
        "bricks": [
          [0,0,1,0,0,0,0,0,0,0]
        ]
      },
        {
        "background": "bg1.png",
        "bricks": [
          [1,1,1,1,1,1,1,1,1,1],
          [1,0,0,0,0,0,0,0,0,1],
          [1,0,1,1,1,1,1,1,0,1],
          [1,0,0,0,0,0,0,0,0,1],
          [1,1,1,1,1,1,1,1,1,1]
        ]
      },
      {
        "background": "bg2.png",
        "bricks": [
          [1,1,1,1,1,1,1,1,1,1],
          [0,0,1,1,1,1,1,1,0,0],
          [1,1,0,0,0,0,0,0,1,1],
          [0,0,1,1,1,1,1,1,0,0],
          [1,1,1,1,1,1,1,1,1,1]
        ]
      }
    ]
  }
  